idiom	alts
american_dream	"[""american dream""]"
catch-22	"[""catch-22""]"
christmas_present	[]
downing_street	[]
elysian_fields	[]
faustian_bargain	[]
great_britain_and_ireland	[]
i_can_tell_you	[]
i_rest_my_case	[]
I'll_be_damned	[]
johnny-come-lately	"[""jonny-come-lately""]"
monday-morning_quarterback	[]
monopoly_money	[]
prince_of_darkness	[]
russian_roulette	[]
santa's_workshop	[]
swiss_bank_account	[]
tom,_dick_and_harry	"[""tom, dick or harry""]"
trojan-horse	[]
a_bridge_too_far	[]
a_hair's_breadth	[]
a_life_of_its_own	[]
above_and_beyond	[]
accident_of_birth	[]
accident_waiting_to_happen	[]
ace_in_the_hole	[]
ace_up_one's_sleeve	[]
acquired_taste	[]
across_the_board	"[""across-the-board""]"
across_the_pond	[]
act_of_congress	[]
add_fuel_to_the_fire	"[""add fuel to fire"", ""add fuel to the flame"", ""pour gasoline on the fire"", ""throw gasoline on the fire"", ""throw gas on the fire""]"
add_insult_to_injury	"[""heap insult on injury""]"
adrenaline_junkie	[]
after_the_fact	[]
again_and_again	[]
against_all_odds	[]
against_the_clock	[]
against_the_grain	[]
against_the_law	[]
against_the_run_of_play	[]
against_the_world	[]
agree_to_disagree	[]
agreement_in_principle	[]
ahead_of_one's_time	[]
ahead_of_the_curve	[]
ahead_of_the_game	[]
alive_and_kicking	[]
all_and_sundry	[]
all_bets_are_off	[]
all_hell_breaks_loose	[]
all_hell_broke_loose	"[""hell broke loose"", ""all hell breaks loose""]"
all_in_a_day's_work	[]
all_it's_cracked_up_to_be	[]
all_one's_eggs_in_one_basket	[]
all_over_the_board	[]
all_over_the_map	[]
all_over_the_place	[]
all_rights_reserved	[]
all_the_marbles	[]
all_things_being_equal	[]
all_things_considered	[]
all_things_to_all_people	"[""all things to all men""]"
almighty_dollar	[]
along_the_lines	[]
ambulance_chasing	[]
an_apple_a_day	[]
an_axe_to_grind	"[""axe to grind""]"
an_offer_one_can't_refuse	[]
ancient_history	[]
and_be_done_with_it	[]
and_his_mother	[]
angle_of_attack	[]
answer_on_a_postcard	[]
anyone's_guess	[]
apple_of_someone's_eye	[]
apples_and_oranges	"[""apples to oranges""]"
area_of_influence	[]
around_the_clock	"[""round the clock""]"
around_the_corner	[]
as_i_was_saying	[]
as_all_get-out	"[""as all get out"", ""as get-out""]"
as_best_one_can	[]
as_far_as_one_knows	[]
as_luck_would_have_it	[]
as_often_as_not	[]
as_the_crow_flies	[]
as_the_day_is_long	[]
as_the_next_guy	"[""as the next girl""]"
ask_the_question	[]
asleep_at_the_switch	[]
assault_and_battery	[]
assume_the_mantle	"[""take up the mantle""]"
assume_the_position	[]
at_a_loss_for_words	[]
at_a_moment's_notice	[]
at_arm's_length	[]
at_cross-purposes	[]
at_death's_door	"[""at death's door""]"
at_each_other's_throats	[]
at_first_blush	"[""at the first blush""]"
at_one's_fingertips	[]
at_sixes_and_sevens	[]
at_the_best_of_times	[]
at_the_coal_face	[]
at_the_drop_of_a_hat	[]
at_the_end_of_one's_tether	"[""at the end of one's rope""]"
at_the_end_of_the_day	[]
at_the_feet_of	[]
at_the_mercy_of	[]
at_the_receiving_end	[]
at_the_top_of_one's_lungs	[]
at_the_top_of_one's_voice	[]
at_the_very_least	[]
at_this_point_in_time	[]
away_from_home	[]
baby-killer	"[""babykiller"", ""baby killer""]"
back_and_forth	"[""back-and-forth""]"
back_in_the_day	"[""back in day""]"
back_of_one's_hand	[]
back_to_the_drawing_board	"[""back to the old drawing board""]"
back_to_the_wall	[]
back-burner	[]
back-of-the-envelope	"[""back-of-an-envelope""]"
back-to-back	[]
back-to-back-to-back	[]
backhanded_compliment	"[""back-handed compliment""]"
bad_taste_in_one's_mouth	[]
balance_the_books	[]
ballpark_figure	[]
balls-out	[]
balls-up	[]
banana_republic	[]
bang_for_the_buck	[]
baptism_by_fire	"[""baptism of fire""]"
bare_one's_soul	"[""lay bare one's soul""]"
bargain_basement	[]
barrel_of_laughs	[]
batten_down_the_hatches	[]
bee_in_one's_bonnet	[]
been_there,_done_that	[]
before_someone's_time	[]
behind_closed_doors	[]
behind_someone's_back	[]
behind_the_counter	[]
behind_the_eight-ball	[]
behind_the_scenes	"[""behind-the-scenes""]"
behind_the_times	[]
behind_the_wheel	[]
believe_it_or_not	[]
believe_one's_ears	[]
believe_one's_eyes	"[""believe one's own eyes""]"
believe_you_me	[]
bells_and_whistles	[]
below_the_belt	[]
bend_over_backwards	"[""lean over backwards""]"
bend_the_rules	[]
beneath_the_surface	[]
beside_the_point	[]
best_laid_plans	[]
best_of_both_worlds	[]
best_of_the_bunch	[]
best_thing_since_sliced_bread	[]
best-kept_secret	[]
bet_one's_bottom_dollar	[]
better_and_better	[]
between_a_rock_and_a_hard_place	[]
between_the_pipes	[]
beyond_the_call_of_duty	[]
beyond_the_pale	[]
bide_one's_time	[]
big_fish_in_a_small_pond	[]
big-boned	"[""big boned""]"
bigger_fish_to_fry	[]
bird's-eye_view	[]
birds_and_bees	"[""the birds and the bees""]"
birds_of_a_feather	[]
bit_between_one's_teeth	[]
bite_of_the_cherry	[]
bite_off_more_than_one_can_chew	[]
bite_one's_tongue	[]
bite_the_bullet	[]
bitter_pill_to_swallow	"[""bitter pill""]"
black_and_blue	"[""black-and-blue""]"
black-on-black	[]
blessing_in_disguise	[]
blink_of_an_eye	[]
blocking_and_tackling	[]
blood_and_guts	[]
blood_in_the_water	[]
blood,_sweat_and_tears	"[""blood, sweat, and tears""]"
blow_off_steam	[]
blow_someone's_mind	[]
blow_the_whistle	[]
blow_up_in_one's_face	[]
blow-by-blow	[]
blue-eyed	[]
blue-eyed_boy	[]
blue-sky_thinking	"[""big-sky thinking""]"
bone_of_contention	[]
bone-crunching	[]
bone-deep	[]
bone-dry	"[""bone dry""]"
boots_on_the_ground	[]
born_with_a_silver_spoon_in_one's_mouth	[]
bottom_fishing	"[""bottom-fishing""]"
bottom_of_the_ninth	[]
bought_and_paid_for	[]
boys_and_girls	[]
bragging_rights	[]
brass-neck	[]
bread_and_butter	[]
bread-and-butter	[]
break_new_ground	[]
break_one's_duck	[]
break_someone's_heart	[]
break_the_back_of	[]
break_the_bank	[]
break_the_cycle	[]
break_the_deadlock	[]
break_the_mold	"[""break the mould""]"
breaking_and_entering	[]
breath_of_fresh_air	[]
breathe_a_sigh_of_relief	[]
brick_and_mortar	"[""brick-and-mortar"", ""bricks and mortar"", ""bricks-and-mortar""]"
brick_by_brick	[]
bricks_and_mortar	[]
bridge_the_gap	[]
bright_and_early	[]
bright-line_rule	[]
bring_home_the_bacon	[]
bring_to_a_boil	"[""bring to the boil"", ""come to a boil""]"
bring_to_justice	[]
bring_to_light	[]
bring_to_the_table	[]
broad_shoulders	[]
broaden_someone's_horizons	[]
broken-hearted	[]
buck_the_trend	[]
bump_and_grind	"[""bump-and-grind"", ""bump-n'-grind"", ""bump n' grind""]"
bump_in_the_road	"[""bump on the road""]"
bundle_of_energy	[]
bundle_of_nerves	[]
buried_treasure	[]
burst_into_tears	[]
burst_out_laughing	[]
burst_someone's_bubble	"[""bust someone's bubble"", ""pop someone's balloon""]"
bury_one's_head_in_the_sand	[]
bury_the_hatchet	[]
business_as_usual	"[""business-as-usual""]"
button-down	"[""buttoned-down""]"
buttoned-down	[]
by_a_long_shot	[]
by_all_accounts	[]
by_any_stretch_of_the_imagination	[]
by_hook_or_by_crook	[]
by_one's_own_hand	[]
by_the_numbers	"[""by-the-numbers""]"
by_the_same_token	[]
by_the_skin_of_one's_teeth	[]
by-the-book	[]
by-the-numbers	[]
call_a_spade_a_spade	"[""call a spade a spade and a shovel a shovel"", ""call a shovel a shovel""]"
call_it_a_night	[]
call_someone's_bluff	[]
call_the_shots	[]
calm_before_the_storm	[]
can't_get_enough	[]
captain's_pick	[]
carrot_and_stick	"[""stick and carrot""]"
carved_in_stone	[]
cast_aspersions	[]
cast_one's_vote	[]
cast_the_first_stone	[]
cat-and-mouse	[]
catch_of_the_day	[]
catch_sight_of	[]
catch_someone's_eye	[]
caught_on_the_hop	[]
caught_stealing	[]
caught_with_one's_pants_down	[]
cease_and_desist	[]
chain_reaction	[]
change_of_heart	[]
change_of_life	[]
change_of_tack	[]
change_one's_mind	[]
change_one's_tune	[]
change_someone's_mind	[]
change_the_channel	[]
character_assassination	[]
charm_offensive	[]
check_and_balance	[]
checks_and_balances	[]
chemical_imbalance	[]
cherry-pick	"[""cherry pick"", ""cherrypick""]"
childhood_friend	[]
chip_off_the_old_block	"[""chip of the old block"", ""chip off the block""]"
chip_on_one's_shoulder	[]
chump-change	[]
circle_the_wagons	[]
cities_and_counties	[]
city_and_county	[]
clean_up_one's_act	[]
clear_one's_lines	[]
clear_the_decks	[]
clock_is_ticking	"[""clock is running""]"
close_one's_eyes	[]
close_to_the_wind	[]
cold_hard_cash	[]
collect_one's_thoughts	"[""gather one's thoughts""]"
come_a_cropper	[]
come_a_long_way	[]
come_down_to_us	[]
come_down_with	[]
come_full_circle	[]
come_hell_or_high_water	[]
come_home_to_roost	"[""the chickens come home to roost""]"
come_in_from_the_cold	[]
come_into_being	[]
come_into_one's_own	[]
come_out_of_one's_shell	[]
come_out_of_the_closet	[]
come_out_of_the_woodwork	"[""crawl out of the woodwork""]"
come_out_swinging	[]
come_thick_and_fast	[]
come_to_a_close	[]
come_to_a_head	"[""bring something to a head""]"
come_to_an_end	[]
come_to_grips_with	[]
come_to_nothing	[]
come_to_one's_senses	[]
come_to_someone's_aid	[]
come_to_someone's_rescue	[]
come_to_terms_with	[]
come_to_the_fore	[]
come_to_the_party	[]
come_to_think_of_it	[]
come_with_the_territory	"[""go with the territory""]"
come-to-jesus	[]
comedy_of_errors	[]
comfortable_in_one's_own_skin	"[""comfortable in one's skin""]"
comfortably_off	[]
coming_out_of_one's_ears	[]
command_performance	[]
concrete_jungle	[]
controlled_substance	[]
cook_the_books	[]
cookie-cutter	[]
cool_one's_heels	[]
cop-out	"[""copout""]"
corner_the_market	[]
corporate_ladder	[]
cost_the_earth	[]
cotton-picking	"[""cotton-pickin'""]"
could_care_less	[]
count_one's_blessings	[]
courage_of_one's_convictions	[]
cradle-to-grave	[]
crash_and_burn	[]
cream_of_the_crop	[]
creature_feature	[]
creme_de_la_creme	"[""cr\u00e8me de la cr\u00e8me""]"
crony_capitalism	[]
cross_someone's_path	[]
cross_the_line	[]
crowd-pleaser	[]
crunch_numbers	[]
crème_de_la_crème	"[""creme de la creme""]"
culpable_homicide	[]
curtain-raiser	"[""curtain raiser""]"
cut_and_thrust	[]
cut_from_the_same_cloth	"[""cut of the same cloth"", ""cut out of the same cloth""]"
cut_one's_teeth	[]
cut_the_mustard	[]
cut_the_umbilical_cord	[]
cut_to_the_chase	[]
date_with_destiny	[]
day_in,_day_out	[]
day-to-day	"[""day to day""]"
daylight_robbery	[]
dead_and_buried	[]
dead_cat_bounce	[]
dead_in_the_water	[]
deafening_silence	[]
deer_in_the_headlights	[]
definitive_agreement	[]
deliver_the_goods	[]
detective_work	[]
devil_is_in_the_details	[]
devil's_advocate	[]
diamond_in_the_rough	"[""rough diamond""]"
dig_in_one's_heels	[]
diminishing_returns	[]
dirt-poor	"[""dirt poor""]"
dismal_science	[]
do_one's_business	[]
do_one's_thing	[]
do_someone_proud	[]
do_the_hard_yards	[]
do_the_honours	"[""do the honors""]"
do_the_right_thing	[]
do-or-die	"[""do or die""]"
dog_and_pony_show	"[""dog-and-pony show""]"
dog's_breakfast	[]
don't_get_me_started	[]
don't_go_there	[]
don't_hold_your_breath	[]
done_and_dusted	[]
donkey's_years	[]
doom_and_gloom	"[""doom-and-gloom""]"
double_entendre	[]
double-edged_sword	[]
down_for_the_count	[]
down_in_the_dumps	"[""in the dumps""]"
down_on_one's_luck	[]
down_the_drain	[]
down_the_toilet	[]
down_the_track	[]
down_the_tubes	"[""down the tube""]"
down_to_a_fine_art	[]
down_to_the_wire	[]
down-to-earth	[]
drag_one's_feet	[]
draw_a_line_in_the_sand	[]
dressed_to_the_nines	[]
dressing-down	"[""dressing down""]"
dribs_and_drabs	[]
drive_someone_crazy	[]
drop_in_the_bucket	[]
drop_in_the_ocean	[]
drug_of_choice	[]
dyed_in_the_wool	[]
dyed-in-the-wool	[]
ear_to_the_ground	[]
earn_one's_keep	[]
easier_said_than_done	[]
easy_on_the_eye	[]
easy_on_the_eyes	"[""easy on the eye""]"
eat_humble_pie	[]
eat_one's_heart_out	[]
eat_someone_alive	[]
eat_someone's_lunch	[]
economical_with_the_truth	[]
element_of_surprise	[]
elephant_in_the_room	[]
elevator_pitch	[]
embarrassment_of_riches	[]
end_of_the_line	[]
end_of_the_world	[]
enemy_combatant	[]
equal_marriage	[]
err_on_the_side_of	[]
err_on_the_side_of_caution	[]
esprit_de_corps	[]
ethically_challenged	"[""ethically-challenged""]"
even_the_score	[]
every_which_way	[]
everything_but_the_kitchen_sink	"[""everything and the kitchen sink"", ""everything including the kitchen sink""]"
exception_that_proves_the_rule	[]
excess_baggage	[]
execution_style	[]
extra_pair_of_hands	[]
eye_for_an_eye	[]
eye_of_the_beholder	[]
eye-opener	"[""eye opener"", ""eyeopener""]"
face_the_music	[]
facts_on_the_ground	[]
failure_to_thrive	[]
fair_and_square	[]
fall_between_the_cracks	[]
fall_by_the_wayside	[]
fall_from_grace	[]
fall_into_one's_lap	[]
fall_into_place	[]
fall_into_the_wrong_hands	[]
fall_off_the_wagon	[]
fall_on_deaf_ears	[]
fall_on_hard_times	[]
fall_on_one's_face	[]
fall_on_one's_sword	[]
fall_through_the_cracks	[]
fan_the_flames	[]
fancy_one's_chances	[]
fashionably_late	[]
fast_and_furious	[]
feast_for_the_eyes	[]
feast_or_famine	[]
feather_in_one's_cap	[]
feeding_frenzy	[]
feel_the_pinch	[]
feet_on_the_ground	[]
female-to-male	[]
few_and_far_between	[]
fight_fire_with_fire	[]
fighting_chance	[]
figure_of_speech	[]
fill_in_the_blank	[]
fill_one's_boots	[]
fill_someone's_shoes	[]
final_nail_in_the_coffin	[]
final_solution	[]
find_another_gear	"[""find a new gear""]"
find_it_in_one's_heart	[]
find_one's_feet	[]
find_one's_voice	[]
fire_in_the_belly	"[""fire in one's belly""]"
fire_on_all_cylinders	"[""hit on all cylinders""]"
fire-breathing	"[""fire breathing""]"
first_among_equals	[]
first_and_last	[]
first_come,_first_served	[]
first_port_of_call	[]
fish_out_of_water	[]
fishing_expedition	[]
fit_for_a_king	[]
fits_and_starts	[]
flash_in_the_pan	[]
flat-chested	"[""flatchested""]"
flat-footed	[]
flight_of_fancy	[]
float_someone's_boat	[]
fly_in_the_face_of	[]
fly_in_the_ointment	[]
fly_off_the_handle	[]
fly_off_the_shelves	[]
fly_on_the_wall	[]
fly-by-night	[]
follow_in_someone's_footsteps	"[""follow in someone's steps""]"
follow_through	[]
food_for_thought	[]
fool's_paradise	[]
for_pete's_sake	[]
for_all_intents_and_purposes	"[""to all intents and purposes"", ""for all intensive purposes"", ""for all intrinsic purposes""]"
for_all_the_world	[]
for_crying_out_loud	"[""for cryin' out loud""]"
for_good_measure	[]
for_goodness'_sake	"[""for goodness sake""]"
for_heaven's_sake	[]
for_old_times'_sake	[]
for_one's_life	[]
for_one's_particular	[]
for_that_matter	[]
for_the_heck_of_it	[]
for_the_hell_of_it	[]
for_the_love_of	[]
for_the_most_part	[]
for_the_time_being	[]
forbidden_fruit	[]
force_someone's_hand	[]
forgive_and_forget	[]
fountain_of_youth	[]
four-leaf_clover	"[""four-leafed clover"", ""four-leaved clover""]"
free-for-all	[]
freedom_of_speech	[]
fresh-faced	[]
friends_in_high_places	[]
from_a_mile_away	[]
from_cover_to_cover	[]
from_pillar_to_post	[]
from_the_bottom_of_one's_heart	[]
from_the_cradle_to_the_grave	"[""from the cradle to the deathbed""]"
from_the_get-go	"[""from the git-go""]"
from_the_ground_up	[]
from_the_word_go	[]
from_time_to_time	[]
front_and_center	"[""front-and-center"", ""front and centre"", ""british"", ""front-and-centre""]"
full_speed_ahead	"[""full steam ahead""]"
full-fledged	"[""fully fledged""]"
full-stretch	[]
garden_variety	"[""garden-variety""]"
genetic_modification	[]
genie_is_out_of_the_bottle	[]
get_a_handle_on	[]
get_a_kick_out_of	[]
get_a_rise_out_of	[]
get_away_with_murder	[]
get_carried_away	[]
get_down_to_business	[]
get_in_on_the_act	[]
get_into_one's_stride	[]
get_into_trouble	[]
get_it_over_with	[]
get_off_one's_chest	[]
get_off_the_ground	[]
get_on_someone's_nerves	[]
get_on_the_end_of	[]
get_one's_act_together	[]
get_one's_feet_wet	[]
get_one's_fill	[]
get_one's_foot_in_the_door	[]
get_one's_hands_dirty	[]
get_one's_hands_on	[]
get_one's_head_around	[]
get_one's_hopes_up	[]
get_one's_money's_worth	"[""have one's money's worth""]"
get_one's_skates_on	[]
get_out_of_here	[]
get_out_of_jail_free_card	"[""get-out-of-jail-free card""]"
get_stuck_into	[]
get_the_ball_rolling	"[""start the ball rolling""]"
get_the_better_of	[]
get_the_hang_of	"[""have the hang of""]"
get_the_picture	[]
get_the_word_out	[]
get_to_grips_with	[]
get_to_the_bottom_of	[]
get_to_the_point	[]
get_under_someone's_skin	[]
get_with_the_program	"[""get with the programme""]"
get-rich-quick	[]
gift_of_the_gab	[]
gift_that_keeps_on_giving	[]
give_it_one's_best_shot	"[""take one's best shot""]"
give_one's_all	[]
give_someone_a_hand	"[""lend someone a hand""]"
give_someone_a_hard_time	[]
give_someone_pause	[]
give_something_a_whirl	[]
give_up_the_ghost	[]
glass-half-empty	"[""glass half empty""]"
glass-half-full	"[""glass half full""]"
glutton_for_punishment	[]
go_against_the_grain	[]
go_all_the_way	[]
go_along_for_the_ride	[]
go_along_to_get_along	[]
go_back_in_time	[]
go_back_to_the_drawing_board	[]
go_belly-up	[]
go_by_the_wayside	[]
go_down_in_flames	[]
go_down_that_road	"[""go down the road"", ""go down a road""]"
go_down_the_drain	[]
go_down_the_road	"[""go down that road"", ""go down a road""]"
go_for_the_gold	"[""go for gold"", ""go for the gold ring""]"
go_for_the_jugular	[]
go_from_strength_to_strength	[]
go_hand_in_hand	[]
go_out_of_one's_way	[]
go_out_on_a_limb	[]
go_out_with_a_bang	[]
go_over_someone's_head	[]
go_pear-shaped	"[""go pearshaped"", ""go pear shaped""]"
go_the_distance	[]
go_the_extra_mile	[]
go_the_whole_hog	"[""go whole hog""]"
go_through_the_motions	[]
go_through_with	[]
go_to_great_lengths	"[""go to extraordinary lengths""]"
go_to_someone's_head	[]
go_to_the_polls	[]
go_to_the_wall	[]
go_underground	[]
go_up_in_flames	[]
go_up_in_smoke	[]
go_with_the_flow	[]
go_without_saying	[]
go-getter	[]
golden_handshake	[]
golden_opportunity	[]
golden_parachute	[]
gone_with_the_wind	[]
good_as_one's_word	[]
good_enough_to_eat	[]
good_for_nothing	[]
good-for-nothing	"[""good for nothing""]"
good-hearted	[]
grasp_the_nettle	[]
grease_the_wheels	[]
great_unwashed	[]
green_with_envy	[]
greener_pastures	[]
grind_to_a_halt	[]
ground-breaking	[]
guilty_pleasure	[]
hair_of_the_dog	[]
hair-splitting	[]
hale_and_hearty	"[""hale and hardy""]"
half-baked	"[""half baked"", ""halfbaked""]"
half-naked	"[""half naked""]"
half-pint	[]
halfway_decent	[]
hammer_and_sickle	[]
hammer_and_tongs	[]
hand_over_fist	[]
hand_over_hand	[]
hand-in-glove	[]
hand-to-mouth	[]
handwriting_on_the_wall	[]
hang_in_the_balance	[]
hang_one's_hat	[]
hang_one's_hat_on	[]
hang_up_one's_boots	[]
happily_ever_after	[]
hard_nut_to_crack	"[""harder nut to crack"", ""hardest nut to crack"", ""difficult nut to crack"", ""tough nut to crack""]"
hard_of_hearing	[]
hard_pill_to_swallow	"[""difficult pill to swallow""]"
hard-and-fast	"[""hard and fast""]"
hard-nosed	[]
hard-pressed	"[""hard pressed"", ""hardpressed""]"
have_a_good_time	[]
have_a_handle_on	[]
have_a_mind_of_one's_own	[]
have_a_mountain_to_climb	[]
have_a_nice_day	[]
have_an_eye_for	[]
have_been_around	"[""have been around the block""]"
have_blood_on_one's_hands	[]
have_it_both_ways	[]
have_it_in_for	[]
have_one's_cake_and_eat_it_too	"[""eat one's cake and have it too""]"
have_one's_eye_on	[]
have_one's_hands_full	"[""have one's handful""]"
have_one's_name_on	"[""have one's name all over"", ""have one's name written all over""]"
have_one's_way	[]
have_one's_way_with	[]
have_second_thoughts	[]
have_someone_going	[]
have_someone's_back	"[""cover someone's back"", ""have got someone's back"", ""get someone's back""]"
have_someone's_number	"[""get someone's number""]"
have_the_floor	[]
have_the_last_laugh	"[""get the last laugh""]"
have_the_time_of_one's_life	[]
he-man	[]
head_and_shoulders	[]
head_for_the_hills	[]
head_over_heels	[]
head_scratcher	"[""head-scratcher""]"
head-on	"[""head on""]"
head-scratching	"[""head scratching""]"
head-the-ball	[]
heads_or_tails	[]
heads_will_roll	[]
heads-up	"[""heads up""]"
heart_and_soul	[]
heart_of_hearts	[]
heart_to_heart	"[""heart-to-heart""]"
heart-breaking	[]
hedge_one's_bets	[]
hell_or_high_water	[]
here_we_go_again	[]
hiding_to_nothing	[]
high_and_mighty	[]
high_on_the_hog	"[""high off the hog""]"
highway_robbery	"[""highway-robbery""]"
hindsight_is_20/20	[]
hit_the_big_time	[]
hit_the_bottle	[]
hit_the_buffers	[]
hit_the_ground_running	[]
hit_the_headlines	[]
hit_the_jackpot	[]
hit_the_nail_on_the_head	[]
hit_the_pavement	[]
hither_and_yon	[]
hive_of_activity	[]
hold_one's_breath	[]
hold_one's_head_high	[]
hold_one's_horses	[]
hold_one's_nerve	[]
hold_one's_own	[]
hold_one's_tongue	[]
hold_someone's_feet_to_the_fire	[]
hold_someone's_hand	[]
hold_the_phone	[]
hold_the_reins	[]
hold_up_one's_end	[]
hold-up_play	[]
holding_pattern	[]
home_and_hosed	[]
home_away_from_home	"[""home from home""]"
home_sweet_home	[]
honorable_mention	"[""honourable mention""]"
hook,_line_and_sinker	"[""rod, line and sinker""]"
hop,_skip,_and_a_jump	[]
hope_against_hope	[]
hormone_therapy	[]
horses_for_courses	"[""courses for horses""]"
hot_and_bothered	[]
hot_on_someone's_heels	[]
hot_under_the_collar	[]
house_of_cards	[]
household_name	[]
hugs_and_kisses	[]
hurt_someone's_feelings	[]
husband_and_wife	[]
hustle_and_bustle	"[""hustle-bustle""]"
if_i_do_say_so_myself	"[""if I say so myself"", ""though I say so myself"", ""though I say it myself""]"
if_nothing_else	[]
ifs,_ands,_or_buts	[]
in_a_heartbeat	[]
in_a_league_of_one's_own	[]
in_all_honesty	[]
in_all_one's_glory	[]
in_any_way,_shape,_or_form	[]
in_at_the_deep_end	[]
in_black_and_white	[]
in_for_the_kill	[]
in_from_the_cold	[]
in_layman's_terms	[]
in_living_memory	[]
in_no_small_measure	[]
in_no_uncertain_terms	[]
in_no_way,_shape,_or_form	[]
in_one's_dreams	[]
in_one's_element	[]
in_one's_pocket	[]
in_one's_right_mind	[]
in_other_words	[]
in_recent_memory	[]
in_someone's_pocket	"[""be in someone's pocket"", ""be in the pocket of someone"", ""in the pocket of someone""]"
in_someone's_shoes	[]
in_the_blink_of_an_eye	[]
in_the_crosshairs	[]
in_the_doghouse	[]
in_the_driver's_seat	"[""in the driving seat""]"
in_the_driving_seat	[]
in_the_face_of	[]
in_the_fast_lane	[]
in_the_final_analysis	"[""in the last analysis"", ""in the ultimate analysis""]"
in_the_first_place	[]
in_the_here_and_now	[]
in_the_hospital	"[""in hospital""]"
in_the_hot_seat	[]
in_the_interest_of_justice	[]
in_the_limelight	[]
in_the_line_of_duty	[]
in_the_long_run	[]
in_the_long_term	[]
in_the_middle_of	[]
in_the_nick_of_time	[]
in_the_process_of	[]
in_the_right_place_at_the_right_time	[]
in_the_running	[]
in_the_same_boat	[]
in_the_same_breath	[]
in_the_short_run	[]
in_the_thick_of	[]
in_the_thick_of_it	[]
in_the_wake_of	"[""in something's wake""]"
in_the_worst_way	[]
in_the_wrong_place_at_the_wrong_time	[]
in_this_day_and_age	[]
in_with_a_chance	[]
in_your_dreams	[]
inch-perfect	[]
inner_strength	[]
inside_baseball	[]
inside_the_box	[]
installed_base	[]
irons_in_the_fire	[]
it_goes_to_show	[]
it_is_what_it_is	[]
it_takes_two_to_tango	[]
it's_about_time	[]
jack_of_all_trades	"[""jack-at-all-trades"", ""jack of all trades"", ""jack of all trades"", ""jack-of-all-trades"", ""jack-of-all-trades""]"
jet-setter	[]
jet-setting	"[""jet setting"", ""jetsetting""]"
joined_at_the_hip	"[""joined-at-the-hip""]"
judge,_jury_and_executioner	"[""judge and jury""]"
jump_at_the_chance	[]
jump_on_the_bandwagon	"[""climb on the bandwagon"", ""hop on the bandwagon""]"
jump_the_queue	"[""jump queue""]"
jump_through_hoops	"[""leap through hoops""]"
jump_to_conclusions	[]
jumped-up	[]
just_like_that	[]
just_what_the_doctor_ordered	[]
kangaroo_court	[]
keep_a_close_watch_on	[]
keep_a_cool_head	[]
keep_a_low_profile	[]
keep_an_eye_on	[]
keep_an_eye_open	[]
keep_an_eye_out	[]
keep_one's_chin_up	[]
keep_one's_cool	[]
keep_one's_eye_on_the_ball	[]
keep_one's_eyes_peeled	[]
keep_one's_fingers_crossed	[]
keep_one's_head	"[""keep one's head on one's shoulders""]"
keep_one's_head_above_water	"[""hold one's head above water"", ""keep one's head above the water""]"
keep_one's_head_down	[]
keep_one's_mouth_shut	[]
keep_one's_options_open	"[""leave one's options open""]"
keep_someone_company	[]
keep_someone_in_the_loop	[]
keep_someone_posted	[]
keep_the_peace	[]
keep_up_appearances	[]
keep_up_with_the_joneses	[]
kernel_of_truth	[]
kettle_of_fish	[]
keys_to_the_kingdom	"[""keys of the kingdom""]"
kick_in_the_pants	"[""kick in the rear""]"
kick_in_the_teeth	[]
kick_the_bucket	[]
kick_the_can_down_the_road	[]
kick_the_habit	[]
kick_the_tires	"[""kick the tyres"", ""kick the wheels""]"
kick_up_one's_heels	[]
kicking_and_screaming	[]
killer_instinct	[]
kindred_spirit	[]
king_of_the_hill	[]
kiss_and_make_up	[]
knife-edge	"[""knife edge"", ""knife's edge"", ""knife's-edge""]"
knight_in_shining_armor	"[""knight in shining armour""]"
knock_someone's_socks_off	[]
know_no_bounds	[]
know_one's_way_around	[]
know_the_score	[]
know_where_one_stands	[]
labour_of_love	[]
laced-up	[]
ladies_and_gentlemen	[]
land_of_opportunity	[]
land_on_one's_feet	"[""fall on one's feet""]"
larger_than_life	[]
last_thing_one_needs	[]
last-ditch	"[""last ditch""]"
laugh_a_minute	[]
laughing_stock	"[""laughingstock"", ""laughing-stock""]"
law_of_the_jungle	[]
lay_down_the_law	[]
lay_of_the_land	[]
lay_the_groundwork	[]
leader_of_the_free_world	[]
leaps_and_bounds	[]
leave_no_stone_unturned	[]
left_and_right	"[""right and left"", ""left, right and center"", ""left, right and centre"", ""right, left and center"", ""right, left and centre""]"
legally_binding	[]
lend_itself_to	[]
lesser_of_two_evils	[]
let_bygones_be_bygones	[]
let_nature_take_its_course	"[""let nature take her course"", ""let nature take its course""]"
let_one's_hair_down	[]
let_someone_go	[]
let_someone_have_it	[]
let_the_cat_out_of_the_bag	[]
let_the_chips_fall_where_they_may	"[""let the dice fall where they may""]"
let_them_have_it	[]
let-down	"[""letdown""]"
level-headed	"[""level headed"", ""levelheaded""]"
licence_to_print_money	"[""license to print money""]"
lick_one's_wounds	[]
life_and_soul_of_the_party	[]
life_is_too_short	[]
life_of_the_party	[]
life-or-death	"[""life-and-death"", ""life or death""]"
light_a_fire_under	[]
light_at_the_end_of_the_tunnel	[]
light_on_one's_feet	[]
lightning_fast	"[""lightning-fast""]"
lightning_in_a_bottle	[]
lightning-quick	[]
lily-livered	[]
line_in_the_sand	[]
line_one's_pockets	[]
live_and_learn	[]
live_and_let_live	[]
live_on_the_edge	[]
live_paycheck_to_paycheck	"[""live paycheque to paycheque"", ""live from paycheck to paycheck""]"
live_the_dream	[]
lock,_stock_and_barrel	[]
long_arm_of_the_law	[]
long_in_the_tooth	[]
long_story_short	[]
long_way_around	[]
look_forward_to	[]
look_on_the_bright_side	[]
look_the_other_way	[]
look-in	[]
loosen_the_purse_strings	"[""loosen the pursestrings"", ""loosen the purse-strings""]"
lose_one's_cool	[]
lose_one's_head	[]
lose_one's_mind	[]
lose_one's_temper	[]
lose_one's_way	[]
lost_in_translation	[]
loud_and_clear	[]
love_at_first_sight	[]
love_of_one's_life	[]
low-down	"[""lowdown""]"
low-hanging_fruit	"[""low hanging fruit""]"
luck_of_the_draw	[]
lump_in_one's_throat	"[""lump to one's throat""]"
made_for_each_other	"[""made for one another""]"
made_of_sterner_stuff	[]
make_a_clean_break	[]
make_a_decision	[]
make_a_difference	[]
make_a_killing	[]
make_a_meal_of	"[""make a meal out of""]"
make_a_mockery_of	[]
make_an_appearance	[]
make_an_example_of	[]
make_ends_meet	[]
make_hay_while_the_sun_shines	[]
make_light_work_of	[]
make_matters_worse	[]
make_no_bones_about	[]
make_one's_bed	[]
make_one's_mark	"[""leave one's mark"", ""make a mark""]"
make_one's_way	[]
make_quick_work_of	[]
make_short_work_of	[]
make_someone's_day	[]
make_the_grade	[]
make_the_most_of	[]
make_up_one's_mind	[]
make_up_the_numbers	[]
male-to-female	[]
man_in_the_street	[]
man_of_few_words	[]
man_of_one's_word	[]
man_of_the_hour	[]
man_of_the_people	[]
man_on_the_street	[]
many_happy_returns	[]
marching_orders	[]
mashed_potatoes	[]
mass_destruction	[]
match_made_in_heaven	[]
matter_of_course	[]
matter_of_fact	[]
matter_of_life_and_death	"[""matter of life or death""]"
matter_of_time	[]
meals_on_wheels	[]
mean_the_world_to	[]
meat_and_potatoes	[]
meet_and_greet	[]
meet_one's_maker	[]
meeting_of_the_minds	"[""meeting of minds""]"
mend_one's_ways	[]
middle_of_nowhere	[]
middle_of_the_road	"[""middle-of-the-road""]"
military_power	[]
mind_one's_own_business	[]
mind-numbing	[]
mint_chocolate_chip	[]
mint_condition	[]
miss_the_point	[]
mixed_blessing	[]
modest_proposal	[]
moment_in_the_sun	[]
moment_of_truth	[]
monkey_business	[]
monthly_meeting	[]
moral_high_ground	[]
more_than_meets_the_eye	[]
more_than_one_bargained_for	[]
morning_person	[]
morning,_noon_and_night	[]
move_heaven_and_earth	[]
move_mountains	[]
move_one's_body	[]
move_the_goalposts	"[""move the goal posts""]"
move_the_needle	[]
mover_and_shaker	[]
much_ado_about_nothing	"[""much adoe about nothing""]"
muddy_the_waters	[]
music_to_someone's_ears	[]
mutual_admiration_society	[]
my_way_or_the_highway	[]
name_and_shame	[]
name_of_the_game	[]
navigable_waters	[]
necessary_evil	[]
neck_of_the_woods	[]
need-to-know	[]
needle_in_a_haystack	"[""needle-in-a-haystack""]"
needless_to_say	[]
neither_here_nor_there	[]
nerve-shredding	[]
nerves_of_steel	[]
never_in_a_million_years	[]
next_big_thing	"[""next big thing""]"
next_to_nothing	[]
next-level	[]
nickel_and_dime	"[""nickel-and-dime""]"
nickel-and-dime	[]
nine_times_out_of_ten	[]
nip_in_the_bud	[]
no_great_shakes	[]
no_hard_feelings	[]
no_harm,_no_foul	[]
no_holds_barred	[]
no_spring_chicken	[]
no_strings_attached	"[""nsa""]"
no_time_to_lose	[]
no_two_ways_about_it	[]
no-show	[]
non-starter	[]
none_of_someone's_business	[]
nook_and_cranny	[]
nose_to_the_grindstone	[]
not_a_pretty_sight	[]
not_by_any_means	[]
not_going_anywhere	[]
not_in_the_least	[]
not_the_end_of_the_world	[]
not_to_mention	[]
not_your_father's	[]
nothing_for_it	"[""nothing else for it""]"
nothing_special	[]
nothing_to_sneeze_at	[]
nothing_to_write_home_about	[]
nowhere_to_be_found	[]
nuts_and_bolts	"[""nuts-and-bolts""]"
off_and_running	[]
off_one's_game	[]
off_one's_meds	[]
off_one's_own_bat	"[""off one's own back""]"
off_one's_rocker	[]
off_the_back_foot	[]
off_the_beaten_path	[]
off_the_beaten_track	[]
off_the_deep_end	[]
off_the_reservation	[]
off_the_top_of_one's_head	[]
off_to_the_races	"[""away at the races"", ""away to the races"", ""off at the races""]"
off-color	"[""off-colour""]"
off-kilter	[]
off-roader	[]
off-the-cuff	[]
off-the-shelf	"[""off the shelf""]"
off-the-wall	"[""off the wall""]"
offer_one's_condolences	[]
oh_my_goodness	[]
old_boy_network	"[""good old boy network"", ""old-boy network""]"
old_enough_to_vote	[]
on_a_regular_basis	[]
on_a_shoestring	[]
on_good_terms_with	[]
on_one's_deathbed	[]
on_one's_hands	[]
on_one's_high_horse	[]
on_one's_knees	[]
on_one's_last_legs	[]
on_one's_own_account	[]
on_one's_plate	[]
on_one's_watch	[]
on_pins_and_needles	[]
on_second_thought	"[""on second thoughts""]"
on_someone's_account	[]
on_someone's_mind	[]
on_tenterhooks	[]
on_the_back_burner	[]
on_the_back_foot	"[""on the back footing""]"
on_the_back_of	[]
on_the_cutting_room_floor	[]
on_the_down-low	"[""on the down low"", ""on the dl""]"
on_the_edge_of_one's_seat	[]
on_the_face_of	"[""in the face of""]"
on_the_face_of_it	[]
on_the_front_foot	[]
on_the_heels_of	"[""upon the heels of""]"
on_the_other_hand	"[""otoh""]"
on_the_other_side_of	[]
on_the_outside,_looking_in	"[""on the outside looking in""]"
on_the_plus_side	[]
on_the_point_of	[]
on_the_rampage	[]
on_the_receiving_end	"[""at the receiving end""]"
on_the_right_track	[]
on_the_same_page	[]
on_the_same_wavelength	[]
on_the_side_of_the_angels	[]
on_the_spur_of_the_moment	"[""spur-of-the-moment"", ""attributive""]"
on_the_up-and-up	"[""on the up and up""]"
on_the_warpath	[]
on_the_wrong_side_of_history	[]
on_top_of_the_world	[]
on-the-spot	[]
once_and_for_all	[]
once_in_a_blue_moon	[]
once_in_a_while	[]
one_after_another	"[""one after the other""]"
one_and_the_same	[]
one_fell_swoop	[]
one_of_these_days	[]
one_of_those_days	[]
one_of_those_things	[]
one_step_ahead	[]
one_step_at_a_time	[]
one-hit_wonder	[]
one-horse_race	[]
one-man_band	"[""one man band""]"
one-night_stand	[]
one-note	[]
one-off	[]
one-star	[]
one-track_mind	[]
one-trick_pony	"[""one trick pony""]"
one-up	[]
one-upmanship	"[""one-upsmanship"", ""one-up-manship"", ""oneupmanship""]"
only_game_in_town	[]
only_time_will_tell	[]
open_someone's_eyes	[]
open_the_floodgates	[]
open-door_policy	"[""open door policy""]"
opposite_number	[]
or_words_to_that_effect	[]
original_character	[]
out_of_character	[]
out_of_nowhere	[]
out_of_one's_box	[]
out_of_one's_depth	[]
out_of_one's_element	[]
out_of_one's_face	[]
out_of_one's_league	[]
out_of_one's_mind	"[""out of one's cotton-picking mind"", ""off one's head""]"
out_of_proportion	"[""out of all proportion""]"
out_of_the_blue	[]
out_of_the_box	"[""out-of-the-box""]"
out_of_the_chute	[]
out_of_the_loop	[]
out_of_the_ordinary	[]
out_of_the_picture	[]
out_of_the_question	[]
out_of_the_running	[]
out_of_the_way	"[""out-of-the-way""]"
out_of_the_woods	[]
out_of_thin_air	"[""from thin air""]"
out_of_this_world	[]
out_of_wedlock	[]
out_on_one's_feet	[]
out_the_window	[]
out-and-out	[]
outside_chance	[]
outside_the_box	[]
over_and_over_again	[]
over_my_dead_body	[]
over_one's_head	[]
packed_to_the_gills	[]
packed_to_the_rafters	[]
pain_and_suffering	[]
pain_in_the_ass	"[""pain in the arse"", ""pita""]"
pain_in_the_butt	[]
pain_in_the_neck	[]
pale_in_comparison	[]
par_for_the_course	"[""course par""]"
paradise_on_earth	"[""paradise on earth""]"
part_and_parcel	[]
parting_of_the_ways	[]
pat_on_the_back	"[""pat-on-the-back""]"
patience_of_a_saint	[]
pay_one's_dues	[]
pay_through_the_nose	[]
peace_and_quiet	[]
peaches_and_cream	"[""peaches-and-cream""]"
peaches-and-cream	"[""peaches and cream""]"
peanut_butter_and_jelly	"[""pb&j"", ""pbj""]"
peanut_gallery	[]
pearl_necklace	"[""pearl-necklace""]"
penny_wise_and_pound_foolish	"[""penny-wise and pound-foolish"", ""penny wise, pound foolish""]"
people's_republic	[]
pick_someone's_brain	[]
pick_up_the_pieces	[]
pick_up_the_tab	[]
piece_de_resistance	[]
piece_of_garbage	[]
piece_of_the_action	[]
piece_of_trash	[]
pile_on_the_pounds	[]
pile-up	"[""pileup"", ""pile up""]"
pill_to_swallow	[]
pinch-hit	[]
pitch-perfect	"[""pitch perfect""]"
pitched_battle	[]
pièce_de_résistance	"[""piece de resistance""]"
place_in_the_sun	[]
place_of_business	[]
play_fast_and_loose	[]
play_one's_cards_right	"[""play one's cards well""]"
play_second_fiddle	[]
play_the_field	[]
play_the_race_card	[]
play_to_the_gallery	[]
play_well_with_others	[]
play_with_fire	[]
pocket-sized	[]
poetry_in_motion	[]
point_the_finger	[]
point_the_finger_at	[]
poisoned_chalice	[]
political_football	[]
politically_correct	"[""pc"", ""p.c.""]"
pop_the_question	[]
porcelain_skin	[]
pot_calling_the_kettle_black	[]
pound_of_flesh	[]
pound_the_pavement	[]
pour_cold_water_on	[]
power_behind_the_throne	[]
powers_that_be	"[""powers-that-be""]"
press_the_panic_button	[]
pressed_for_time	[]
pretty_pictures	[]
price_is_right	[]
price_on_one's_head	[]
prim_and_proper	[]
private_branch_exchange	[]
professional_student	[]
project_management	[]
protest_too_much	[]
psychological_warfare	[]
pub-crawl	[]
public_comment	[]
public_intellectual	[]
pull_one's_punches	[]
pull_one's_socks_up	[]
pull_one's_weight	"[""pull one's own weight""]"
pull_out_all_the_stops	[]
pull_the_trigger	[]
pull_the_wool_over_someone's_eyes	"[""pull wool over someone's eyes""]"
pull_up_a_chair	[]
pull_up_stakes	[]
punch_above_one's_weight	"[""hit above one's weight""]"
pure_and_simple	[]
purely_and_simply	[]
push_one's_luck	[]
push_someone's_buttons	"[""press someone's buttons""]"
push_the_boat_out	[]
push_the_envelope	"[""stretch the envelope""]"
put_a_crimp_in	[]
put_a_damper_on	"[""put a dampener on""]"
put_a_foot_wrong	[]
put_all_one's_eggs_in_one_basket	[]
put_down_roots	[]
put_food_on_the_table	[]
put_into_practice	"[""put in practice""]"
put_on_a_pedestal	"[""place on a pedestal"", ""set on a pedestal""]"
put_on_one's_dancing_shoes	[]
put_on_the_map	[]
put_one's_best_foot_forward	"[""put one's best foot foremost""]"
put_one's_cards_on_the_table	"[""lay one's cards on the table"", ""place one's cards on the table"", ""put it all on the table"", ""put it on the table""]"
put_one's_feet_up	[]
put_one's_finger_on	[]
put_one's_foot_down	[]
put_one's_foot_in_one's_mouth	[]
put_one's_hands_together	[]
put_one's_head_in_the_sand	[]
put_one's_house_in_order	"[""get one's house in order"", ""put one's household in order"", ""set one's house in order""]"
put_one's_mind_to_it	[]
put_one's_money_where_one's_mouth_is	[]
put_out_a_fire	[]
put_out_of_one's_misery	[]
put_out_to_pasture	[]
put_someone_under	[]
put_the_boot_in	[]
put_the_brakes_on	"[""put on the brakes""]"
put_the_cart_before_the_horse	[]
put_the_fear_of_god_into	"[""rub the fear of god into""]"
put_the_hammer_down	[]
put_the_kibosh_on	[]
put_the_pedal_to_the_metal	"[""pedal to the metal"", ""put pedal to the metal""]"
put_through_its_paces	[]
put_to_the_sword	[]
put_to_the_test	[]
put_two_and_two_together	[]
put_up_or_shut_up	[]
put_words_in_someone's_mouth	[]
quarter-pounder	[]
quick_off_the_mark	[]
quick-and-dirty	"[""quick and dirty""]"
quick-fire	"[""quickfire""]"
race_against_time	[]
rags_to_riches	"[""rags-to-riches""]"
rain_on_one's_parade	[]
raise_eyebrows	[]
raise_one's_hand	[]
raise_the_roof	[]
raise_the_stakes	[]
razor-sharp	"[""razor sharp""]"
reach_for_the_stars	[]
reach-around	"[""reacharound""]"
read_someone's_lips	[]
read_someone's_mind	[]
reasonable_person	[]
red_letter_day	"[""red-letter day""]"
red-faced	"[""redfaced""]"
reinvent_the_wheel	[]
remain_to_be_seen	[]
rest_on_one's_laurels	[]
return_to_form	[]
rhyme_or_reason	"[""rhyme nor reason""]"
ride_one's_luck	[]
ride_roughshod_over	"[""run roughshod over""]"
ride_the_..._train	[]
rise_and_shine	[]
rise_from_the_ashes	[]
rise_to_the_challenge	[]
rise_to_the_occasion	[]
road_to_damascus	[]
rob_peter_to_pay_paul	[]
rocket_science	[]
rogues'_gallery	"[""rogue gallery""]"
roll_back_the_years	[]
roll_off_the_tongue	"[""roll from the tongue"", ""roll from one's tongue"", ""run from the tongue"", ""run off the tongue"", ""trip from the tongue"", ""trip off the tongue""]"
roll_one's_eyes	[]
roll_out_the_red_carpet	[]
roll_up_one's_sleeves	[]
roof_over_one's_head	[]
room_for_doubt	[]
rooting_interest	[]
rose-colored_glasses	"[""rose-coloured glasses"", ""rose-tinted glasses"", ""rose-colored lenses"", ""rose-coloured spectacles"", ""rose-tinted spectacles""]"
rose-coloured	"[""rose-colored""]"
rough_and_ready	"[""rough-and-ready""]"
rough_around_the_edges	"[""rough round the edges""]"
round_of_applause	[]
round_the_bend	"[""around the bend""]"
round_the_clock	[]
rule_the_roost	[]
run_a_red_light	[]
run_around_with	[]
run_down_the_clock	[]
run_for_one's_money	[]
run_for_the_hills	[]
run_in_the_family	[]
run_into_the_ground	[]
run_one's_course	[]
run_out_of_steam	[]
run_out_of_town	[]
run_out_the_clock	[]
run_rings_around	"[""run rings round""]"
run_the_clock_down	[]
run_the_gauntlet	"[""run the gantlet""]"
sabre-rattling	"[""saber-rattling""]"
safe_and_sound	[]
salt_in_the_wound	[]
salt_of_the_earth	[]
same_old_same_old	"[""same old, same old"", ""same-old, same-old"", ""same-old same-old"", ""same old-same old"", ""same ol' same ol'"", ""same ol', same ol'"", ""same-ol' same-ol'"", ""same ol'-same ol'""]"
same_old_story	[]
save_someone's_skin	[]
scared_to_death	[]
school_of_hard_knocks	[]
scrape_through	[]
scrape_together	[]
scratch_one's_head	[]
scratch_the_surface	[]
screw-up	[]
scrimp_and_save	[]
scum_of_the_earth	[]
seat-of-the-pants	[]
second-guess	"[""second guess""]"
see_eye_to_eye	"[""see eye-to-eye""]"
see_someone's_point	"[""get someone's point""]"
see_the_forest_for_the_trees	"[""see the wood for the trees"", ""see the forest but for the trees"", ""see the forest through the trees"", ""see the trees through the forest""]"
see_the_light_of_day	[]
sell_one's_soul	[]
sell-by_date	[]
seller's_market	[]
send_someone_packing	[]
separate_the_wheat_from_the_chaff	"[""sort the wheat from the chaff"", ""winnow the wheat from the chaff"", ""winnow grain from chaff""]"
set_in_one's_ways	[]
set_one's_heart_on	"[""have one's heart set on"", ""have one's heart set upon"", ""set one's heart upon""]"
set_one's_sights_on	"[""set sights""]"
set_pulses_racing	[]
set_the_wheels_in_motion	[]
set_the_world_on_fire	[]
sex,_drugs_and_rock_'n'_roll	[]
sexual_tension	[]
sharp-elbowed	[]
she'll_be_right	[]
shoo-in	"[""shoo in"", ""shoe-in"", ""shoe in""]"
shoot_first_and_ask_questions_later	[]
shoot_the_breeze	[]
shoot_the_messenger	"[""kill the messenger""]"
short_and_sweet	[]
short_end_of_the_stick	"[""short end""]"
shot_across_the_bow	"[""shot across the bows""]"
shot_in_the_arm	[]
shot_in_the_dark	[]
shotgun_approach	[]
shotgun_wedding	[]
shoulder_to_cry_on	[]
shout_from_the_rooftops	[]
show_one's_face	[]
shrinking_violet	[]
shut_one's_mouth	[]
shut_the_door_on	"[""close the door on"", ""slam the door on""]"
sick_and_tired	[]
sigh_of_relief	[]
sight_for_sore_eyes	[]
sight_to_behold	[]
sign_of_the_times	[]
sign_on_the_dotted_line	[]
significance_level	[]
silver-tongued	[]
simple_english	[]
sing_the_praises_of	[]
sink_one's_teeth_into	[]
sit_on_one's_hands	[]
sit_on_the_fence	[]
sitting_pretty	[]
six_feet_under	[]
six_of_the_best	[]
skin_and_bones	"[""skin and bone""]"
skin_in_the_game	[]
slack-jawed	"[""slackjawed""]"
slanging_match	[]
slap_in_the_face	[]
slap_on_the_wrist	"[""slap on the hand""]"
sleep_together	[]
sleeping_giant	[]
slice_of_the_pie	"[""slice of the cake""]"
slip_of_the_tongue	[]
slip_through_the_cracks	[]
slip_under_the_radar	[]
slip-up	"[""slipup""]"
slippery_slope	[]
slow_on_the_uptake	[]
slow-walk	"[""slow walk""]"
slowly_but_surely	[]
small_potatoes	[]
smear_campaign	[]
smoke_and_mirrors	[]
smoke-filled_room	[]
smooth_operator	[]
smooth_sailing	[]
snakes_and_ladders	"[""snakes-and-ladders""]"
so-and-so	"[""so and so""]"
so-called	[]
socialized_medicine	[]
soft_underbelly	[]
something_awful	[]
something_like	[]
somewhere_along_the_line	[]
song_and_dance	[]
soup-to-nuts	[]
spaghetti_western	"[""spaghettI western"", ""spaghettI western""]"
spare_no_effort	[]
speak_one's_mind	[]
speak_someone's_language	[]
special_delivery	[]
special_interest	[]
special_measures	[]
spectator_sport	[]
speed_merchant	[]
spick_and_span	[]
spick-and-span	"[""spic and span"", ""spick and span""]"
spill_the_beans	[]
spine-tingling	[]
spit-and-polish	[]
spitting_distance	"[""shouting distance""]"
split_the_difference	[]
spoilt_for_choice	[]
spring_in_one's_step	[]
spring_to_life	[]
spring_to_mind	[]
spur_of_the_moment	"[""spur-of-the-moment"", ""attributive""]"
square_peg_in_a_round_hole	[]
stab_in_the_back	[]
stage_of_the_game	[]
stalking_horse	"[""stalking-horse""]"
stand_a_chance	[]
stand_corrected	[]
stand_on_its_own	[]
stand_on_one's_own_two_feet	[]
stand_one's_ground	[]
stand_the_test_of_time	[]
stand_to_reason	[]
stand_up_and_be_counted	"[""stand and be counted""]"
stars_are_aligned	[]
stars_in_one's_eyes	[]
starting_price	[]
state_of_affairs	[]
stay_the_course	"[""stay the distance""]"
steady_the_ship	"[""right the ship""]"
steady-as-she-goes	[]
steal_someone's_thunder	[]
steal_the_show	[]
steely-eyed	[]
step_up_one's_game	"[""up one's game""]"
step_up_to_the_plate	[]
stepping_stone	"[""stepping-stone""]"
stick_in_the_mud	"[""stick-in-the-mud""]"
stick_one's_head_in_the_sand	[]
stick_one's_neck_out	[]
stick_one's_nose_in	[]
stick_to_one's_guns	"[""stick by one's guns""]"
stick_together	[]
stick-in-the-mud	[]
sticking_point	"[""sticking-point""]"
sticky_fingers	[]
stiff_upper_lip	[]
stir-crazy	"[""stir crazy""]"
stop_and_smell_the_roses	"[""smell the roses"", ""stop and smell the flowers"", ""stop to smell the roses""]"
stop_at_nothing	[]
straight_and_narrow	"[""strait and narrow""]"
straight_arrow	[]
straight_shooter	"[""straight-shooter""]"
straighten_out	[]
strange_bedfellows	[]
streets_behind	[]
stretch_one's_legs	[]
stretch_the_truth	[]
strike_a_chord	[]
strike_it_rich	[]
strike_through	[]
strike_while_the_iron_is_hot	[]
string_attached	[]
string_of_pearls	[]
string_to_one's_bow	[]
strings_attached	[]
strut_one's_stuff	[]
stumbling_block	"[""stumbling-block"", ""stumbling blocke""]"
stumbling-block	[]
such-and-such	"[""such and such""]"
suffer_fools_gladly	"[""gladly suffer fools""]"
summer_and_winter	[]
surprise_surprise	[]
suspend_one's_disbelief	[]
swaddling_clothes	[]
swallow_one's_pride	[]
sweet_nothings	[]
sweeten_the_pot	[]
sweetheart_deal	[]
sweetness_and_light	[]
swing_for_the_fences	"[""swing for the fence""]"
swing_of_things	[]
swings_and_roundabouts	[]
switch-hitter	"[""switch hitter""]"
tail_between_one's_legs	[]
tail_wagging_the_dog	[]
take_a_back_seat	[]
take_a_breather	[]
take_a_crack_at	[]
take_a_dim_view_of	[]
take_a_picture	[]
take_a_stab_at	[]
take_a_turn_for_the_better	[]
take_a_turn_for_the_worse	[]
take_exception	[]
take_for_granted	[]
take_into_account	[]
take_into_consideration	[]
take_it_from_me	"[""you can take it from me"", ""you may take it from me""]"
take_it_or_leave_it	[]
take_it_out_on	[]
take_it_outside	[]
take_liberties	[]
take_matters_into_one's_own_hands	[]
take_no_for_an_answer	[]
take_no_prisoners	[]
take_one's_chance	[]
take_one's_eye_off_the_ball	[]
take_one's_hat_off_to	[]
take_one's_lumps	[]
take_one's_pick	[]
take_one's_time	[]
take_out_the_trash	[]
take_someone's_word_for_it	[]
take_the_bull_by_the_horns	[]
take_the_field	"[""take to the field""]"
take_the_fifth	[]
take_the_game_to	[]
take_the_law_into_one's_own_hands	"[""take law into one's own hands""]"
take_the_mickey	"[""mickey-take"", ""take the michael"", ""take the mick""]"
take_the_plunge	[]
take_the_point	"[""take someone's point"", ""take your point"", ""take one's point"", ""take my point"", ""take point of""]"
take_the_reins	[]
take_the_stand	[]
take_the_wheel	[]
talent_management	[]
talk_of_the_town	[]
taste_of_one's_own_medicine	[]
teach_someone_a_lesson	[]
teething_problems	[]
teething_troubles	[]
tell_it_like_it_is	[]
tell_the_truth	[]
tell_you_the_truth	[]
tempest_in_a_teapot	[]
test_the_waters	"[""test the water""]"
thank_one's_lucky_stars	[]
that's_just_me	[]
that's_saying_something	[]
the_ball_is_in_someone's_court	"[""have the ball in one's court""]"
the_bee's_knees	[]
the_buck_stops_here	[]
the_end_of_one's_rope	[]
the_hell_out_of	[]
the_icing_on_the_cake	[]
the_long_and_short	"[""the long and the short""]"
the_plot_thickens	[]
the_rest_is_history	[]
the_rubber_meets_the_road	"[""the rubber hits the road"", ""the tackies hit the tar""]"
the_straw_that_broke_the_camel's_back	[]
the_upper_hand	[]
the_wheels_came_off	[]
the_wheels_fell_off	"[""the wheels came off"", ""the wheels fell off the bus"", ""the wheels came off the bus"", ""the wheels fell off the wagon"", ""the wheels came off the wagon""]"
the_whole_nine_yards	[]
the_world_over	[]
there_and_back	[]
there_for_everyone_to_see	[]
there_you_have_it	"[""there one has it""]"
thick_and_thin	[]
thick_of_things	[]
thin_end_of_the_wedge	"[""small end of the wedge"", ""thin edge of the wedge""]"
thin-skinned	[]
things_that_go_bump_in_the_night	[]
think_on_one's_feet	[]
think_the_world_of	[]
this,_that,_and_the_other	"[""this, that, or the other""]"
thorn_in_someone's_side	[]
thorn_in_the_flesh	[]
thread_the_needle	[]
three-ring_circus	[]
through_and_through	[]
through_the_roof	[]
throw_a_spanner_in_the_works	"[""throw a spanner into the works""]"
throw_a_tantrum	[]
throw_caution_to_the_wind	"[""toss caution to the wind""]"
throw_down_the_gauntlet	"[""throw down the gantlet""]"
throw_good_money_after_bad	[]
throw_in_the_towel	[]
throw_one's_hat_in_the_ring	"[""throw one's hat into the ring"", ""toss one's hat in the ring""]"
throw_one's_weight_around	[]
throw_the_baby_out_with_the_bathwater	"[""throw out the baby with the bathwater"", ""throw out the baby with the bath water"", ""throw the baby out with the bath water""]"
throw_the_book_at	[]
thumb_on_the_scale	"[""thumb on the scales""]"
thumb_one's_nose	[]
tick_all_the_boxes	[]
tickle_someone's_fancy	[]
tie_someone's_hands	[]
tie_up_loose_ends	[]
tight-lipped	"[""tightlipped""]"
time_after_time	[]
time_and_material	[]
time_of_the_month	"[""that time of the month""]"
time_will_tell	"[""only time will tell"", ""time alone will tell""]"
tip_of_the_hat	"[""tip o' the hat""]"
tip_of_the_iceberg	[]
tip_one's_hand	[]
tip_the_scales	"[""tip the scale""]"
tip-off	[]
to_all_intents_and_purposes	"[""for all intents and purposes""]"
to_be_named_later	[]
to_little_avail	[]
to_one's_heart's_content	[]
to_say_nothing_of	[]
to_say_the_least	[]
to_tell_the_truth	[]
to_the_nth_degree	[]
to_the_tune_of	[]
toast_of_the_town	[]
toe-to-toe	"[""toe to toe""]"
tongue-in-cheek	"[""tongue in cheek""]"
tongue-tied	[]
too_big_for_one's_boots	[]
too_clever_by_half	[]
toot_one's_own_horn	"[""blow one's own horn""]"
tooth_and_nail	"[""tooth and claw""]"
top_of_the_line	[]
top-shelf	[]
toss-up	"[""tossup"", ""toss up""]"
total_clearance	[]
touch-and-go	[]
touchy-feely	[]
tough_as_nails	[]
tough_nut_to_crack	"[""tougher nut to crack"", ""toughest nut to crack"", ""difficult nut to crack"", ""hard nut to crack""]"
traditional_marriage	[]
transcendental_meditation	[]
trending_topic	[]
trial_by_media	[]
trials_and_tribulations	[]
trick_up_one's_sleeve	[]
tried_and_tested	[]
tried_and_true	[]
trigger-happy	"[""trigger happy"", ""triggerhappy""]"
trouble_in_paradise	[]
try_one's_hand	[]
try_one's_luck	[]
turn_a_blind_eye	[]
turn_a_deaf_ear	[]
turn_of_events	[]
turn_of_phrase	[]
turn_one's_back	[]
turn_one's_nose_up	[]
turn_over_a_new_leaf	[]
turn_someone's_head	[]
turn_the_corner	"[""turn a corner""]"
turn_the_other_cheek	[]
turn_the_screw	[]
turn_the_tables	[]
turn_upside_down	"[""turn upside-down""]"
turn-off	[]
turn-on	[]
twilight_years	[]
twist_someone's_arm	[]
two-bit	[]
two-edged_sword	[]
two-way_street	[]
under_lock_and_key	[]
under_no_circumstances	[]
under_one's_breath	[]
under_one's_hat	[]
under_one's_nose	[]
under_one's_own_steam	[]
under_one's_thumb	[]
under_one's_wing	[]
under_the_carpet	[]
under_the_cosh	[]
under_the_covers	[]
under_the_impression	[]
under_the_influence	[]
under_the_knife	[]
under_the_microscope	[]
under_the_pump	[]
under_the_radar	[]
under_the_table	"[""under-the-table""]"
under_the_weather	[]
under_the_wire	[]
under_the_yoke	[]
unknown_quantity	[]
until_the_cows_come_home	"[""till the cow come home"", ""'til the cows come home"", ""till the cows come home""]"
up_and_running	[]
up_one's_sleeve	[]
up_someone's_alley	"[""right up someone's alley"", ""up someone's street""]"
up_someone's_street	[]
up_to_something	[]
up-and-comer	[]
up-and-coming	"[""up and coming""]"
up-to-date	"[""up to date"", ""uptodate""]"
upper-crust	"[""upper crust""]"
upset_the_applecart	"[""upset the apple cart""]"
use_one's_head	[]
valley_of_death	[]
valley_of_the_shadow_of_death	[]
verbal_assault	[]
vertically_challenged	"[""vertically-challenged""]"
virgin_territory	[]
voice_in_the_wilderness	"[""call in the wilderness"", ""cry in the wilderness"", ""voice calling in the wilderness"", ""voice crying in the wilderness""]"
vote_with_one's_feet	[]
wake_up_and_smell_the_coffee	[]
walk_a_tightrope	[]
walk_and_chew_gum_at_the_same_time	[]
walk_away_from	[]
walk_down_the_aisle	[]
walk_in_the_park	"[""stroll in the park"", ""walk after lunch""]"
walk_on_the_wild_side	[]
walk_the_plank	[]
wall_of_silence	[]
warm-blooded	[]
wash_one's_hands	[]
wash_one's_hands_of	[]
watch_one's_step	[]
watch_this_space	[]
water_under_the_bridge	[]
watered-down	"[""watered down""]"
wave_of_the_hand	[]
wave_the_white_flag	"[""raise the white flag"", ""hoist the white flag"", ""show the white flag""]"
weak-kneed	"[""weak in the knees""]"
wear_one's_heart_on_one's_sleeve	[]
weather_the_storm	[]
wedding-cake	[]
wee_small_hours	[]
weekend_warrior	[]
weight_of_the_world	[]
well_and_truly	[]
well-oiled	[]
well-padded	[]
wet_behind_the_ears	"[""green behind the ears"", ""wet-behind-the-ears""]"
wet_one's_pants	[]
whack-a-mole	"[""whac-a-mole"", ""whac-a-mole""]"
what_are_the_odds	[]
what_can_i_say	[]
what_do_i_know	[]
what_do_you_say	[]
what_else_is_new	[]
what_someone_said	[]
what_you_see_is_what_you_get	"[""what-you-see-is-what-you-get""]"
what's_cooking	[]
what's_going_on	[]
what's_in_it_for_me	[]
what's_the_difference	[]
what's_the_matter	[]
whatever_it_takes	[]
when_all_is_said_and_done	"[""when all's said and done"", ""after all is said and done""]"
when_push_comes_to_shove	[]
when_the_chips_are_down	[]
whistle-blower	"[""whistleblower"", ""whistle blower""]"
whistle-stop	[]
white_elephant	[]
white-knuckle	"[""white knuckle""]"
whys_and_wherefores	[]
wide_of_the_mark	[]
wild-goose_chase	"[""wild goose chase""]"
willful_ignorance	[]
wind_at_one's_back	[]
window_dressing	"[""window-dressing""]"
window-shopping	[]
wipe_the_slate_clean	[]
wireless_network	[]
wishful_thinking	[]
with_a_grain_of_salt	[]
with_a_vengeance	[]
with_a_view_to	[]
with_all_due_respect	[]
with_an_eye_to	[]
with_an_eye_towards	[]
with_bated_breath	"[""with 'bated breath"", ""with baited breath""]"
with_both_hands	[]
with_flying_colors	"[""with flying colours""]"
with_one's_bare_hands	[]
with_one's_head_held_high	[]
with_open_arms	[]
with_the_manner	[]
within_living_memory	[]
without_a_hitch	[]
without_further_ado	"[""without further to-do"", ""without further to do""]"
wolf_in_sheep's_clothing	[]
word_on_the_street	[]
word_to_the_wise	[]
word-for-word	[]
work_one's_butt_off	"[""work someone's butt off""]"
work_one's_magic	[]
world-beater	[]
worse_for_wear	[]
worst_of_both_worlds	[]
worth_every_penny	[]
worth_its_weight_in_gold	[]
worth_one's_salt	[]
worth_one's_while	[]
wouldn't_hurt_a_fly	[]
wouldn't_you_know	[]
wouldn't_you_know_it	"[""wouldn't you know""]"
wrap_one's_head_around	[]
wriggle_out_of	[]
writing_on_the_wall	"[""handwriting on the wall""]"
wrong_place_at_the_wrong_time	[]
wrong_side_of_the_tracks	[]
year_in,_year_out	[]
yellow_brick_road	[]
yellow_journalism	[]
you_shouldn't_have	[]
you're_telling_me	[]
young_at_heart	[]
younger_brother	[]
younger_sister	[]
zero-day	"[""zero day"", ""0-day""]"
beat_around_the_bush	"[""beat about the bush""]"
have blood on one's hands	"[""have one's blood on one's hands""]"
come down to earth	[]
